		NO ./acacia_log.png
SO ./andesite.png
     WE ./birch_log.png

EA ./grass_block_side.png

F 228,100,0             


C 225,30,0

		
11111111111111111111111
10000000000000000000001
10000000000111100000001
10000000000111100000001
10000000000000000000001
10001000000000000010001
10001000000000000010001
1000110000000E111110001
10000100000000000010001
11111111111111111111111




