		NO ./texture.xpm
SO ./texture.xpm
     WE ./texture.xpm

EA ./texture.xpm

F 228,100,0             


C 225,30,0

		
11111111111111111111111
10000000000000000000001
10000000000111100000001
10000000000111100000001
10000000000000000000001
100010000000W0000010001
10001000000000000010001
10001100000000111110001
10000100000000000010001
11111111111111111111111




